x.............................................................................................................................x
x.............................................................................................................................x
x.............................................................................................................................x
x.............................................................................................................................x
x........h.......................h..................h..........h...................h...............h......................h...x
x.....c...................................c..........................c.................................................c......x
x^^^^------^^^^^^^^^^^^------^^^^^^^^^^^^^^^^^^^^------^^^^------^^^^^^^^^^^^^^^^------^^^^^^^^^^^^------^^^^------^^^^^^^^^^^x
x-----------------------------------------------------------------------------------------------------------------------------x
