x..............................................................................x
x..............................................................................x
x..............................................................................x
x..............................................................................x
x..............................................................................x
x...........................e..................e...............................x
x^^^------^^-------------^^^^------------------^^---------^^------^^^^---------x
x------------------------------------------------------------------------------x
