x.............................................................................................................................x
x.............................................................................................................................x
x.............................................................................................................................x
x.............................................................................................................................x
x.....c..h.......................h........c.........h..........h.....c.............h...............h...................c..h...x
x.............................................................................................................................x
x^^^^------^^^^^^^^^^^^------^^^^^^^^^^^^^^^^^^^^------^^^^------^^^^^^^^^^^^^^^^------^^^^^^^^^^^^------^^^^------^^^^^^^^^^^x
x-----------------------------------------------------------------------------------------------------------------------------x
